NO ./path_to_the_north_texture
SO ./path_to_the_south_texture
WE ./path_to_the_west_texture
EA ./path_to_the_east_texture

F 220,100,0
C 225,30,0

111111111111111111111111
1000000000110000000000001
1011000001110000000000001
10010000000000000000000011111111
11111111101100000111000000000000111
10000000011000001110111111111111
1111011111111100000010001111111
111101111   11111011101010010001
11000000111101011100000010001111
100000001000000001100000010001
10000000000000001101010010001
1100000111010101N1110111100111
11110111011101011101111010001
1111111111111111 111111111111